XXXXXXXXXXXXXXXXXXXXXXXXXXXXXXXXXXXXXXX
X------------X-----X------------------X
X------------X-----X--------X---------X
X-----X------X-----X--------X---------X
X-----X------X-----X--------X---------X
X-----X------X-----X----XXXXXXXXXX----X
X-----X------X-----X--------X---------X
X-----X------X-----X--------X---------X
X-----X------X-----X--------X----XXXXXX
X-----X------X--------------X-------F-X
X-----X------X--------------X-------F-X
X-----X------X-----X--------X-------F-X
X-----X------X-----X--------X----XXXXXX
X-----X------X-----X--------X---------X
X-----X------X-----X--------X---------X
X-----X------X-----X----XXXXXXXXXX----X
X-----X------X-----X--------X---------X
X--P--X------------X--------X---------X
X-----X------------X------------------X
XXXXXXXXXXXXXXXXXXXXXXXXXXXXXXXXXXXXXXX