XXXXXXXXXXXXXXXXXXXX
X------------------X
X--------X---------X
X--------X---------X
X--------X---------X
X--------X---------X
X--------X---------X
X--------X---------X
X----P---X---FFF---X
XXXXXXXXXXXXXXXXXXXX
