XXXXXXXXXXXXXXXXXXXX
X------------------X
X------------------X
X-----X------X-----X
X-----X------X-----X
X-----X------X-----X
X-----X------X-----X
X-----X------X-----X
X-----X--FF--X-----X
X--XXXXXXXXXXXXXX--X
X-----X---P--X-----X
X-----X------X-----X
X-----X------X-----X
X-----X------X-----X
X-----X------X-----X
X-----X------X-----X
X-----X------X-----X
X------------------X
X------------------X
XXXXXXXXXXXXXXXXXXXX