XXXXXXXXXXXXXXXXXXXX
XP-----------------X
X--------X---------X
X--------X---------F
X--------X---------F
X--------X---------F
X--------X---------X
X--------X---------X
X------------------X
XXXXXXXXXXXXXXXXXXXX
