XXXXXXXXXXXXXXXXXXXXXXXXXXXXXXXXXXXXXXXX
XXXX-----XX--X-XXX-----X-X--XXX-----XXXX
XX-X--X------X----X-XX-XXXX--X-XX-XXXXXX
X--XX--X--XXXXXXX--XXX---X-X--XXX--X-XXX
XX-X---X-XXX-X---XXXXX----XXX-X-X--X--XX
X-XXXX-X-X---XXXX---X-X-X--XXXXX--XXXX-X
X-X-X----X---XX-XX-X--XX--X-XXX-X--X-X-X
X-X----X----XXXXX--X-X----XX-X--XX-XX--X
X-XX--X-X------XX--XXX--X---XX--X-X---XX
XX-----XXXXX-X--X-X--X-XX-X--XXX----X--X
X-XX-X-X-XPXXX--X-X-X-X-XX-X-XXX------XX
XX--X------X--X---XXX-XXX--XXXXXX-X-X--X
X-X--XX--XXX---X--X-X--XX-X-XXXXX-XXXXXX
X--X---XX--XXXXX--X---X-----XXXX-X-X---X
XXXX-XX-X-----XF--X--X--X-XX--X-XXXXXXXX
X-X--XX-X---XXXF-X-X--XX-XX-X-XXXX----XX
X-XX--X-----XX-F-X--X-XX--XXX-X-XXX--X-X
XX-----XX-XXX---X---X---X-XX-----XXX-XXX
X--XXX-X-X-X--X-X-----XXX------XX-X-XXXX
X-X-X-X--X--XXX-X-X-XXXX-X------X----X-X
X----XXXX-X-X-------XXXXXX---XX--X-XX-XX
XXX-X-X---XX---XX--X---XXXX-XXX----XXXXX
XXX-XX-XX---X-----X--X---XX--X-X-XXX-X-X
XXX-XX-X-X--XXXXX--XX-XXX-X-X-XX-X-----X
X----X-X-XX---XX---X----X-X-X-----XX---X
X-X-XXXXX---XXX-X----X--X--X---X---X--XX
X-XX--XX---------XXXXX--X---XX--XXX-XXXX
X--XX-XX--XX---XXX-X--XX-XX-X----XXX---X
XXX-X-X-X-XX--X--XX-X-X---X----X-XX-X--X
XXXXXXXXXXXXXXXXXXXXXXXXXXXXXXXXXXXXXXXX
