XXXXXXXXXXXXXXFFFXXX
X------------------X
X------------------X
X------------------X
X------------------X
X------------------X
X------------------X
X------------------X
X----P-------------X
XXXXXXXXXXXXXXXXXXXX
