XXXXXXXXXXXXXXFFFXXX
X------------------X
X--X-------X-------X
X------------------X
X------------------X
X---X---------X----X
X------------------X
X---------------X--X
X----P------X------X
XXXXXXXXXXXXXXXXXXXX
