XXXXXXXXXXXXXXXXXXXXXXXXXXXXXXXXX
X------X-----X--------X---------X
X------X-----X--------X---------X
X------X-----X----XXXXXXXXXX----X
X------X-----X------------------X
X------------X------------------X
X-----------------------------XXX
X-----XXXX------------X-------F-X
X---------------------X-------F-X
X---------------------X-------F-X
X-----------------------------XXX
X-------------------------------X
X--------------------XXX--------X
X------------X--------X---------X
X------------X--------X---------X
X------------X------------------X
XXXXXXXXXXXXXXXXXXXXXXXXXXXXXXXXX 