XXXXXXXXXXXXXXXXXXXXXXXXXXXXXXXXXXXXXXXXXXXXXXXXXXXXXXXXXXXXXXXX
XXXXXXXXXXXXXXXXXXXXXXXXXXXXXXXXXXXXXXXXXXXXXXXXXXXXXXXXXXXXXXXX
XXXXXXXXXXXXXXXXXXXXXXXXXXXXXXXXXXXXXXXXXXXXXXXXXXXXXXXXXXXXXXXX
XXXXXXXXXXXXXXXXXXXXXXXXXXXXXXXXXXXXXXXXXXXXXXXXXXXXXXXXXXXXXXXX
XXXXXXXXXXXXXX-----------------------------------XXXXXXXXXXXXXXX
X--------------------------XXXXX-------------------------------X
X--------------------XXXXXXXXXXXXXXXX--------------------------F
X----------------XXXXXXXXXXXXXXXXXXXXXXXX----------------------F
X----------------XXXXXXXXXXXXXXXXXXXXXXXX ---------------------F
X--------------------XXXXXXXXXXXXXXXX------------XX------------X
XXXX----------------------XXXXX-----------------XXXX-----------X
XXXXXXX----------------------------------------XXXXXX----------X
XXXXXXXXXX-------------------------------------XXXXXX----------X
XXXXXXXXXXXXXXXXXXXXXXX-------------------------XXXX-----------X
XXXXXXXXXXXXXXXXXXXXXX---------------------------XX----------XXX
XXXXXXXXXXXXXXXXXXXXXXXXXXXXXXXXXX-----------------------XXXXXXX
XXXXXXXXXXXXXXXXXXXXXXXXXXXXXXXXXXXXXXXXXXXXXXXXXXXXXXXXXXXXXXXX
XXXXXXXXXXXXXXXXXXXXXXXXXXXXXXXXXXXXXXXXXXXXXXXXXXXXXXXXXXXXXXXX