XXXXXXXXXXXXXXXXXXXXXXXXXXXXXXXXX
X------X-----X--------X---------X
X------X-----X--------X---------X
X------X-----X----XXXXXXXXXX----X
X------X-----X------------------X
X------------X------------------X
X-----------------------------XXX
X-----XXXXXX-----X------------F-X
X-----X----X------X-----------F-X
X-----XXXXXX-------X----------F-X
X-----------------------------XXX
X---------------X---------------X
X---------------------XX--------X
X---------------------XX--------X
X--P---J--------------XX--------X
X---------------------XX--------X
XXXXXXXXXXXXXXXXXXXXXXXXXXXXXXXXX