XXXXXXXXXXXXXXXXXXXXFFFXXXXXXXXXX
X-------------------------------X
X-------------------------------X
X-------------------------------X
X---------------X------------X--X
X----------X--------------------X
X-------------------------------X
X----------------X----X---X-----X
X---------X---------------------X
X-------------------------------X
X-------------------------------X
X----X-------------X--------X---X
X-------------------------------X
X-------------------------------X
X-------------------------------X
X-------------J------XX----P----X
XXXXXXXXXXXXXXXXXXXXXXXXXXXXXXXXX